City Of Stars (From "La La Land" Soundtrack) - Ryan Gosling / Emma Stone
Eleven Weeks - Vansire
在加纳共和国离婚 - 菲道尔 / Dior大颖
Come to Life - Kanye West
Bad Night - James Maddock
爱我别走 - 张震岳
Hotel California (Live On MTV, 1994) - Eagles
晚婚 (Live) - 李宗盛
Megalobox - Mabanua
Nothing's Going to Change My Love For You - Westlife
Genesis. - RAYE
SHINE - The Birthday
Let's Find Each Other Tonight - José Feliciano
Off You - The Breeders
Somewhere Only We Know - Rhianne
How Deep Is Your Love - Bee Gees
I Started A Joke - Bee Gees
Without You - Badfinger
소년이여 - G-DRAGON
我们俩 - 郭顶
Lose Yourself - Eminem
Way Down We Go - KALEO
Viva La Vida - Coldplay
Easy on Me - Adele
I Drink Wine - Adele
黑白风景 - 沙漏SAALAU
Croatian Rhapsody - Maksim
What A Catch, Donnie - Fall Out Boy
Long Long Time - Linda Ronstadt
Long Long Time - Nick Offerman
Can't Keep It Inside - Benedict Cumberbatch
Last Mile Home (Acoustic Version) - Kings of Leon
Tin Lover - The Paper Kites
...Baby One More Time (from Kung Fu Panda 4) - Tenacious D
Say It to Me Now(Album Version) - Glen Hansard
Angie - The Rolling Stones
Brown Sugar - The Rolling Stones
Let It Be (Remastered) - The Beatles
Hotel California (2013 Remaster) - Eagles
I Want It That Way - Backstreet Boys
With Or Without You - U2
Respect - Aretha Franklin
I Want To Hold Your Hand (Remastered) - The Beatles
Billie Jean - Michael Jackson
Like a Virgin - Madonna
Come As You Are - Nirvana
Smells Like Teen Spirit - Nirvana
Yesterday (Remastered) - The Beatles
Beautiful - Carole King
You've Got A Friend - Carole King
Imagine - John Lennon
会魔法的老人 (LIVE版) - 法老 / 李毅杰PISSY / 科科爆
城西舞厅 - 法老 / 龚琳娜
Lover - Taylor Swift
Heavy Wave - Motorama
Gloria: In Excelsis Deo - Patti Smith / Van Morrison
After the Gold Rush - Patti Smith
Swag - Miyauchi
我用什么把你留住 (Live) - 福禄寿FloruitShow
朝 Asa - Mandarin
艳火 - 张悬
南方 - 达达乐队
2 the Sky - Funky DL / Stee Moglie
孔雀 - 蛙池
莫欺少年穷 - 九连真人
Stay - Lewis Watson
Step Back! - 1nonly / Sxmpra
给所有知道我名字的人 (Live) - 羽·泉
阿司匹林 - 王以太
I Am Hip Hop - 王以太
还没想好 - 王以太 / 谢帝
请珍重 - 罗大佑
If I Don't See You Again - Neil Diamond
生活倒影 - 苏运莹
If I Ain’t Got You (Live) - Maroon 5
Morning Paradise - Amaksi
Girls Like You (Acoustic) - Matt Johnson
operate - DMT / jay squared / Chance Thrash
You Belong To Me - Bob Dylan
我是女菩萨 - 白光
Intro - The xx
Homecoming - Josh Ritter
The Sound of Silence - Simon & Garfunkel
5:10a.m. - 傻子与白痴
Cherry Wine - Grentperez
Bordeaux, Aussi Une Couleur (波尔多也是一种颜色) - Jasing Rye
We Can't Stop - Scott Bradlee’s Postmodern Jukebox
日落计数器 - 莫非定律乐团
梦里水乡 - 陈婧霏
セルフノート - THE CHARM PARK
如瓮 - 石岩
有的人 (DEMO) - 超级工场
与时间赛跑的人 - A公馆
Die For You Grabbitz remix - OFF ROADER
人间惆怅客 - 皇后皮箱
匿名的好友 - 小包Zerinn
Sugar - Maroon 5
Freedom - Kygo / Zak Abel
Past Lives - sapientdream / Slushii
Demons - Imagine Dragons
A Higher Place - Adam Levine
Love Me Like You Do - Ellie Goulding
Golden hour - JVKE
And Then You - Greg Laswell
你给我听好 - 陈奕迅
南方姑娘 - 赵雷
Love From The Other Side - Fall Out Boy
All Falls Down - Alan Walker / Noah Cyrus / Digital Farm Animals / Juliander
Free Loop - Daniel Powter
忽然之间 - 莫文蔚
Good Goodbye - Linkin Park / Pusha T / Stormzy
欠父亲的话 - 赵雷
红色高跟鞋 - 蔡健雅
East of Eden - Zella Day
Chasing Pavements - Adele
遇见 - 孙燕姿
We Can't Stop - Boyce Avenue / Bea Miller
Shallow - Lady Gaga / Bradley Cooper
Dream It Possible - Delacey
独家记忆 - 陈小春
Shape of You - Ed Sheeran
ALWAYS HAVE ALWAYS WILL - 费尔倪多 / A1 TRIP
明歌 - 鲜克
儿时 - 刘昊霖
Free Animal - Foreign Air
Rocket Man - Elton John
脏艺术家 - MC HotDog 热狗
I miss your Christmas - Kid Travis
蜀绣 - 李宇春
天天 - 陶喆
花,太阳,彩虹,你 - Mai / 法老 / 肯迪仔 / NoLabelCrew
爱情的枪 live - 左小祖咒 / 笑傲江湖马戏乐团
遥不可及的你 - 花粥
Homeward Bound - Steven Sharp Nelson
僕が死のうと思ったのは - 中島美嘉
42 - Coldplay
Good Morning Mr. Wolf - Patrick Watson
Loving Strangers - Jocelyn Pook / Russian Red
Fix You - Coldplay
面会菜 - 林生祥
ENDLESS RAIN - X JAPAN
寂寞难耐 - 李宗盛
姗姗 - 金玟岐
男孩别哭 - 海龟先生
说再见 - 本能實業
And We Will Fly - Saskia Bruin
Intro: I have a lot to say - 昨夜派对（L.N Party）
A Sad Me In Your Eyes - 昨夜派对（L.N Party）
Nightwish - Nightwish
Cello Suite No. 1 in G Major, BWV 1007:I. Prelude - Alexander Rudin
将进酒 - 厨子和戏子
Skinny Love - Birdy
The Best Is Yet To Come - Aoife Ní Fhearraigh
Art of life live - X JAPAN
玫瑰往事 - 昨夜派对（L.N Party）
Tears (Classical Version) - YOSHIKI
Catch A Dream - 方大同
The Man Who Can't Be Moved - The Script
Roar - Katy Perry
原来的我 - 陈楚生
有谁共鸣 (Live) - 张国荣
大梦 (Live) - 瓦依那 / 任素汐
Never Give up on Your Dreams - Two Steps From Hell
When We Talk - Inspirative
挂断 - 冰冷端
一生所爱 - 卢冠廷 / 莫文蔚
流沙 - 陶喆
Gimme! Gimme! Gimme! (A Man After Midnight) - ABBA
How Long - Charlie Puth
Anti-Hero (feat. Bleachers) - Taylor Swift / Bleachers
dilemma - Nelly
Hey Ho - Gin Wigmore
Hey, Soul Sister - Train
Closer - The Chainsmokers / Halsey
Love In The Dark - Adele
Crazy In Love - Beyoncé / JAY-Z
Time In A Bottle (from Fast & Furious Presents: Hobbs & Shaw) - Yungblud
Setting Fires - The Chainsmokers / XYLØ
爱你的宿命 (live) - The One
Solo Dance - Martin Jensen
Photograph - Ed Sheeran
Can't Help Falling in Love - Haley Reinhart
乌云 - Dark Q
伪装 - 大壮
Move Your Body (Alan Walker Remix) - Alan Walker / Sia
God Damnit - ILLENIUM / Call Me Karizma
等 - L1VET..
Riptide - Vance Joy
We Own the Night - The Wanted
Waterfalls - TLC
一般的一天 - Wiz_H张子豪
喜帖街 - 谢安琪
death bed (coffee for your head) - Powfu / beabadoobee
我记得 - 赵雷
南山南 - 马頔
Highway To Hell - AC/DC
Lucky One - mich
Komm, süsser Tod ／甘き死よ、来たれ (M-10 Director’s Edit. Version) - arianne schreiber
我能chua - 马飞
若把你 - Kirsty刘瑾睿
起风了 - 吴青峰
クロノスタシス - きのこ帝国
爱江山更爱美人 - 阿虾
Red Right Hand - Nick Cave & the Bad Seeds
你怎么不上天呢 - Mr. Miss
寂寞先生 - 曹格
那又如何 - 应嘉俐
Journey - Corrinne May
勇 - 杨千嬅
The Times They Are A-Changin' - Bob Dylan
L'Estro Armonico No. 6 in A Minor:III. Presto - Academy of St. Martin in the Fields / Neville Marriner
我也喜欢你的女朋友 - 脏手指 Oh! Dirty Fingers
追梦赤子心 - GALA
California Dreamin' - The Beach Boys
**** You (Instrumental Version) - Dr. Dre
太平洋西岸的歌(demo) - 风子
如果有我 - 龙井说唱益晗 / 张伯宏
给你呀 (又名：for ya) - 蒋小呢
Yellow - Coldplay
El Pueblo Unido - Hannes Wader
迷途未返 - 葡萄不愤怒
あいという - plenty
Call of Silence x YouSeeBIGGIRL - EYAir
城市孤独病 - 姜云升
我是真的爱你 - 张过年
川流止息之处 - 白色海岸The White Coast
FMD - 澤野弘之
那就这样吧 - 蔡程昱
星空 - 林ゆうき
Maxwell's Silver Hammer (Remastered) - The Beatles
Sick Boy - The Chainsmokers
无法离地的飞行 - 痛仰乐队
现実という名の怪物と戦う者たち - 高橋優
Aerial - Keith Kenniff
把音量调最大 有话对你讲 - 周婧琳
An Empty Space - Dustin O'Halloran / Gyda Valtysdottir
I Will Always Be There (The Lighthouse Symphony Pt 1) - Alnea
所有人都在玩手机 - 马赛克
快拿我的冲浪板来，我要网上冲浪 - JK.Chen
MELANCHOLY - White Cherry
傲寒 - 马頔
Arctic - Sleeping at Last
道别是一件难事 - 上海彩虹室内合唱团
忘记我 (现场版) - 上海彩虹室内合唱团
Family - The Weeknd / Suzanna Son
Cradles - Sub Urban
Scared 2 Be Lonely - Lil Tjay
lovely - Billie Eilish / Khalid
sand dream - Revo / 梶浦由記
人间萤火 - 夏日入侵企画
路边野餐 - Aliosha
世界が終るまでは... - WANDS
If I Ain't Got You (Acoustic) - John Adams
可乐 - 赵紫骅
The Waiting Game - Steve Gibbons
百年孤寂 - 王菲
打上花火 - Daoko / 米津玄師
还你 - 新学校废物合唱团
再谈记忆 - 盘尼西林
Kiss from a Rose - Seal
Harvest Moon - Neil Young
As It Was - Harry Styles
CAN'T STOP THE FEELING! (Original Song from DreamWorks Animation's "TROLLS") - Justin Timberlake
浪费 - 徐佳莹
Stay With Me - Sam Smith
夜空中最亮的星 - 逃跑计划
I'm Not The Only One - Sam Smith
Pop - 脏手指 Oh! Dirty Fingers
Aamir - STOLEN秘密行动
September 5th - Kyte
Untitled - Halifax Pier
The Real Folk Blues - 山根麻以
越过山丘 - 杨宗纬
Fur Elise - Ludwig van Beethoven
Continental Blues - Mighty Mo Rodgers
在你死后才想起曾经答应陪你去散步 - 康士坦的变化球
翼をください - タンポポ児童合唱団
就让这大雨全都落下 - 容祖儿
美错 - 王菲
The Carnival of the Animals (1995 Remastered Version):The Swan - Jacqueline du Pré
如果你也听说 - 张惠妹
Coffee - beabadoobee
Goodbye Moonmen - RICK AND MORTY / Jemaine Clement / Ryan Elder
That Girl - Olly Murs
我想在城市里当一个乡下人 - 小米
龙王 (Live) - 钢心
25 (Live) - 鸟撞 Birdstriking
美好的事可不可以发生在我身上 (Live) - 康士坦的变化球
地球仪 (Live) - 五条人
I Am You - Kim Taylor
孤雏 - AGA
Lemon - 米津玄師
慢慢喜欢你 - 莫文蔚
And The Winner Is - Gérard Darmon
Turn Me On - Norah Jones
一窗清响 - 高敏惠
The Show - Lenka
芬里尔 - 那奇沃夫
When INTP Tries To Flirt - Benjamin Spicy
August Rush Rhapsody [Original - Mark Mancina
Main Titles - Ramin Djawadi
The Rumbling - SiM
Call your name <Gv> - 澤野弘之 / R!N/Gemie
Red Swan - YOSHIKI / Hyde
Red Christmas (Classical Version) - YOSHIKI
River Flows In You - Lindsey Stirling
她从来不听我写的歌 - 咖喱3000
海がきこえる - 永田茂
最后难过的人不是我 - Peace Hotel(和平饭店)
Laugh It Off - Post Malone
猛犸 - 后海大鲨鱼
Dissolve (acoustic) - Absofacto / NiteShift
Diet Mountain Dew (1st Demo) - Lana Del Rey
空山 MØUNTAIN - advly / warmice
我绝对不能失去你 - GALA
夕海月 - ゴンチチ
All I Can Remember - 李东俊
The air is on fire - Every Silver Lining Has A Cloud
Got to Give It Up - Marvin Gaye
Stand by Me - Seal
Pretty Please (feat. NNAVY) - Uncle Maximilien / NNAVY
This Old Guitar - John Denver
孤独的人是可耻的 - 张楚
答应不爱你 - 郑中基
落花流水 - 陈奕迅
唯一 - 王力宏
当我离开你的时候 - 左小祖咒 / 陈珊妮
两个科学家在吃面 - 马飞
灵魂歌手 - 梁博
Katrina - 陶喆
世界上不存在的歌 (2020重唱版) - 陈奕迅
道山靓仔 - 五条人
悲怆奏鸣曲 - Ludwig van Beethoven
Slumberland - Should
10月のあなた - 関取花
spirit (strings ver.) - 澤野弘之
むすめ - 関取花
I Know the Words You'll Say to Me - Scythelence
Light A Fire - Alisa
New Boy - 朴树
爱就一个字 - 张信哲
Cello Suite No. 1 in G Major, BWV 1007:I. Prélude - 马友友
Cello Suite No. 1 in G Major, BWV 1007:I. Prélude - 马友友
Cello Suite No. 1 in G Major, BWV 1007:II. Allemande - 马友友
小丑女 - 杨和苏KeyNG
祝愿你能有个很好的未来 - 姜云升
迄今为止的生命里 - 姜云升
你消失后 - 姜云升 / 刘美麟
我想 (remix) (LIVE版) - 法老
有没有那么一首歌 - 张茜
椿 - 沈以诚
You're Beautiful - James Blunt
坊间传说 Intro - 泥鳅Zinco
让我快乐 - 杨和苏KeyNG
很久很久 - 杨和苏KeyNG
醉鬼的敬酒曲 (酒馆版) - 上海彩虹室内合唱团
初恋旧爱新欢 - RAiNBOW计划 / 林力尧
离开 - MC HotDog 热狗 / 张震岳
亲密爱人2017 (feat. 酷癌) - 法老 / 酷癌KooEye
Manchester - Kishi Bashi
pure imagination - Rook1e / J'san
Young Dumb & Broke - Joseph Vincent
Vanishing Act (Live) - Lou Reed
Goldberg Variations, BWV 988:Aria - Glenn Gould
南三环东路 - DOUDOU
Aperture - Jordan Critz
Home - Michael Bublé
一般的一天 (LIVE版) - Wiz_H张子豪
送你的歌 - 姜云升 / 温政贤SeanWen
Напои меня водой - Неприкасаемые
凄美地 - 郭顶
水星记 - 郭顶
保留 - 郭顶
梦里梦外 - Jam
浪子回頭 - 茄子蛋
Is It Just Me? - Sasha Alex Sloan / Charlie Puth
Life Is Wonderful (Live in Amsterdam) - Jason Mraz
这世界那么多人 - 莫文蔚
Honey - Running Blue
Remember the Name (feat. Styles of Beyond) - Fort Minor / Styles of Beyond
为你我受冷风吹 (Live) - 梁静茹
Waiting For Love (Extended Mix) - Avicii
Like I Would (Tom Budin Remix) - Tom Budin / ZAYN
how to be alone - Bri Tolani
约定(Live) - 陈奕迅
没有理想的人不伤心 - 新裤子
山丘 - 李宗盛
无尽光芒 - 许巍
现在现在 - 麻园诗人
如梦 - 陈婧霏
泸沽湖 - 麻园诗人
带我去找夜生活 - 告五人
我还年轻 我还年轻 - 老王乐队
好心分手 - 卢巧音 / 王力宏
Cold December Night - Michael Bublé
蓝莲花 - 许巍
杀死那个石家庄人 - 万能青年旅店
再见杰克 - 痛仰乐队
极恶都市 - 夏日入侵企画
曾经的你 - 许巍
三十岁的女人 - 赵雷
给自己的歌 - 李宗盛
History - 88rising / Rich Brian
克什米尔山羊 - Capper / YOUNG13DBABY / kattie凯欣 / SanJin
Vagrant Poet - 洛仃洋
回忆如同猛兽，我们手无寸铁 - 野岸刊
Vagrant Poet 2 - 洛仃洋
For Emma - Bon Iver
New Boy - 房东的猫 / 陈婧霏
我的孤独认出你的孤独 - 陈婧霏
硬汉 - 腰乐队
街摇 Gel! - Capper
遗孤 Xiaoshan of gods - Capper / Cool-Aid陈轶伦
Dream Odyssey - MONO
Open Arms - SZA / Travis Scott
7 Years (Later) [Live] - Lukas Graham
站台 The Platform - royster lee
Daylight - Seredris
shall we talk. - 8bite
不后悔遇见你 - 姜云升 / 朴冉
Battle - 姜云升
围城 - 姜云升 / 张雪飞 / Lil.Fred
圣诞结 - 陈奕迅
还有事情可庆祝 - 杨千嬅
忏悔录 - KKECHO / 那奇沃夫 / REDBOI
Beside Me - Spylent
红豆 - 王菲
心墙 - 郭静
所以你睡了没 - 沙一汀EL
骗自己PT.2 - AY楊佬叁 / Noor-99
双子座 - 沙一汀EL
你一定能够成为你想要去成为的人 - 姜云升
自白书 僵尸 feat 梁老师T.$ong - 梁老师Tsong / 姜云升
毕业典礼 (Live版) - 嘻哈融合体
Take Me To Church - Hozier
孤注一掷 - 姜云升 / 奉天乐队
从无到有 feat 安列 - 姜云升
28.7 - 姜云升 / 朴冉
自由舞步 - 张希